########
#      #
#G#### #
###### #
#S#### #
#      #
########