##########
#      ###
#S####   #
#      # #
######## #
###G     #
##########