##############
# # # ###  #G#
# # #   # ## #
#   # #   ## #
## ## # # ## #
##    # #    #
#### ## ######
#S   ##      #
##############