##############
##          G#
## ######### #
## #       # #
## # ##### # #
##   #     # #
#### # ##### #
#S   #       #
##############