#######################
#                     #
# ######### ######### #
# #                 # #
# # ############### # #
# # #             # # #
# # # ##### ##### # # #
# # # #         # # # #
# # # # ####### # # # #
# # # # #     # # # # #
# #   #   #S#   #   #G#
# # # # #     # # # # #
# # # # ####### # # # #
# # # #         # # # #
# # # ##### ##### # # #
# # #             # # #
# # ############### # #
# #                 # #
# ######### ######### #
#                     #
#######################