############
#S         #
#          #
#          #
#    G     #
#          #
#          #
#          #
############