##############################
##############S###############
###                       ####
### ############## ###### ####
### ############## ###### ####
################## ###### ####
### ############## ###### ####
###      G                ####
##############################
              #