###############################
####                 ##########
##   ###################   # ##
## ####                # # # ##
## ################### # # # ##
##                     # # # ##
###################### # # # ##
##   ##                # # # ##
## # ## ### ## ######### # # ##
## #    #   ##G#         # # ##
## # ## ################ # # ##
#### ##             #### # # ##
#### ############## ## # # # ##
####             ##    # # # ##
####### ######## ####### # # ##
####### ####             #   ##
#S      #######################
###############################