#############
#          G#
# # # # #   #
#          S#
# # # # # # #
#           #
#############