####################
#S##########    ####
# ##      ## #######
# ## ####    #######
# ## #### ##   #####
#    #### #### #####
#### #### ##   #####
##   #### #### #####
## ####     G    ###
####################